AmtB	PROTEIN	AMTB-MONOMER
AsnB	PROTEIN	ASNSYNB-MONOMER
B12s	SIMPLE_MOLECULE	COB-I-ALAMIN
B12s_Ext	SIMPLE_MOLECULE	COB-I-ALAMIN_Ext
BioDex 1-	SIMPLE_MOLECULE	CADAVERINE
BioDex 1-_Ext	SIMPLE_MOLECULE	CADAVERINE_Ext
BtuB	PROTEIN	EG10126-MONOMER
BtuB-ExbD-ExbB-TonB	COMPLEX	CPLX0-1924
CO2	SIMPLE_MOLECULE	CARBON-DIOXIDE
CadA	PROTEIN	LYSDECARBOX-MONOMER
CadB	PROTEIN	CADB-MONOMER
DctR	PROTEIN	EG11889-MONOMER
ExbB	PROTEIN	EG10271-MONOMER
ExbD	PROTEIN	EG10272-MONOMER
GABA	SIMPLE_MOLECULE	4-AMINO-BUTYRATE
GABA_Ext	SIMPLE_MOLECULE	4-AMINO-BUTYRATE_Ext
GadA	PROTEIN	GLUTDECARBOXA-MONOMER
GadB	PROTEIN	GLUTDECARBOXB-MONOMER
GadC	PROTEIN	XASA-MONOMER
GadE	PROTEIN	EG11544-MONOMER
GadW	PROTEIN	EG12242-MONOMER
GadX	PROTEIN	EG12243-MONOMER
GlnK	PROTEIN	PROTEIN-PII2
HdeA	PROTEIN	EG11398-MONOMER
HdeB	PROTEIN	EG11399-MONOMER
HdeD	PROTEIN	EG11495-MONOMER
Hns	PROTEIN	PD00288
L-glutamate	SIMPLE_MOLECULE	GLT
L-glutamate_Ext	SIMPLE_MOLECULE	GLT_Ext
Lon	PROTEIN	EG10542-MONOMER
MdtE	PROTEIN	EG12240-MONOMER
MdtF	PROTEIN	YHIV-MONOMER
MurI	PROTEIN	GLUTRACE-MONOMER
RNA:IS183	PROTEIN	IS183-RNA
RcsB	PROTEIN	RCSB-MONOMER
RcsB-GadE	COMPLEX	CPLX0-7852
RpoA	PROTEIN	EG10893-MONOMER
RpoB	PROTEIN	RPOB-MONOMER
RpoB-RpoC-RpoA-RpoS	COMPLEX	RNAPS-CPLX
RpoC	PROTEIN	RPOC-MONOMER
RpoS	PROTEIN	RPOS-MONOMER
Slp	PROTEIN	EG11890-MONOMER
TolC	PROTEIN	EG11009-MONOMER
TolC-MdtE-MdtF	COMPLEX	TRANS-CPLX-204
TonB	PROTEIN	EG11012-MONOMER
UspE	PROTEIN	EG11246-MONOMER
YbaS	PROTEIN	G6261-MONOMER
YbaT	PROTEIN	B0486-MONOMER
YhiD	PROTEIN	EG11400-MONOMER
ammonium	SIMPLE_MOLECULE	AMMONIUM
ammonium_Ext	SIMPLE_MOLECULE	AMMONIUM_Ext
asnB	GENE
asnB_mRNA	RNA
asparagine	SIMPLE_MOLECULE	ASN
aspartate	SIMPLE_MOLECULE	L-ASPARTATE
btuB-murI	GENE
btuB-murI_mRNA	RNA
cadBA	GENE
cadBA_mRNA	RNA
cobinamide	SIMPLE_MOLECULE	COBINAMIDE
cobinamide_Ext	SIMPLE_MOLECULE	COBINAMIDE_Ext
diphosphate	SIMPLE_MOLECULE	PPI
drug	SIMPLE_MOLECULE	|Drugs|
drug_Ext	SIMPLE_MOLECULE	|Drugs|_Ext
gadAX	GENE
gadAX_mRNA	RNA
gadBC	GENE
gadBC_mRNA	RNA
gadE	GENE
gadE-mdtEF	GENE
gadE-mdtEF_mRNA	RNA
gadE_mRNA	RNA
gadW	GENE
gadW_mRNA	RNA
gadX	GENE
gadXW	GENE
gadXW_mRNA	RNA
gadX_mRNA	RNA
gadY	GENE
gadY_mRNA	RNA
glnK-amtB	GENE
glnK-amtB_mRNA	RNA
glu	SIMPLE_MOLECULE	D-GLT
glutamine	SIMPLE_MOLECULE	GLN
hdeAB-yhiD	GENE
hdeAB-yhiD_mRNA	RNA
hdeD	GENE
hdeD_mRNA	RNA
hns	GENE
hns_mRNA	RNA
lon	GENE
lon_mRNA	RNA
lysine	SIMPLE_MOLECULE	LYS
lysine_Ext	SIMPLE_MOLECULE	LYS_Ext
peptide	SIMPLE_MOLECULE	|Peptides-holder|
protein	SIMPLE_MOLECULE	|General-Protein-Substrates|
rpoS	GENE
rpoS_mRNA	RNA
slp-dctR	GENE
slp-dctR_mRNA	RNA
uspE	GENE
uspE_mRNA	RNA
ybaST	GENE
ybaST_mRNA	RNA
