5-ketogluconate	SIMPLE_MOLECULE
5-ketogluconate	SIMPLE_MOLECULE	5-DEHYDROGLUCONATE
5-ketogluconate_Ext	SIMPLE_MOLECULE	5-DEHYDROGLUCONATE_Ext
6-p gluconate	SIMPLE_MOLECULE	CPD-2961
GntK	PROTEIN	GLUCONOKINII-MONOMER
GntR	PROTEIN	PD03585
GntU	PROTEIN	GNTU-MONOMER
IdnD	PROTEIN	IDONDEHYD-MONOMER
IdnK	PROTEIN	GLUCONOKINI-MONOMER
IdnO	PROTEIN	GLUCONREDUCT-MONOMER
IdnR	PROTEIN
IdnR-5-ketogluconate	COMPLEX
IdnR-idonate	COMPLEX
IdnT	PROTEIN	YJGT-MONOMER
gluconate	SIMPLE_MOLECULE	GLUCONATE
gluconate_Ext	SIMPLE_MOLECULE	GLUCONATE_Ext
gntK	GENE
gntKU	GENE
gntKU_mRNA	RNA
gntK_mRNA	RNA
gntRKU	GENE
gntRKU_mRNA	RNA
idnDOTR	GENE
idnDOTR_mRNA	RNA
idnK	GENE
idnK_mRNA	RNA
idonate	SIMPLE_MOLECULE
idonate	SIMPLE_MOLECULE	L-IDONATE
idonate_Ext	SIMPLE_MOLECULE	L-IDONATE_Ext
