3',5'-ADP	SIMPLE_MOLECULE	3-5-ADP
3-morpholinopropanal	SIMPLE_MOLECULE	CPD-16549
AlaA	PROTEIN	G7184-MONOMER
CO2	SIMPLE_MOLECULE	CARBON-DIOXIDE
Cbl	PROTEIN	G7071-MONOMER
CysA	PROTEIN	CYSA-MONOMER
CysA-CysW-CysU-CysP	COMPLEX	ABC-7-CPLX
CysB	PROTEIN
CysB-acetylserine	COMPLEX
CysB-sulfide	COMPLEX
CysB-thiosulfate	COMPLEX
CysC	PROTEIN	ADENYLYLSULFKIN-MONOMER
CysD	PROTEIN	CYSD-MONOMER
CysD-CysN	COMPLEX	SULFATE-ADENYLYLTRANS-CPLX
CysE	PROTEIN	SERINE-O-ACETTRAN-MONOMER
CysE-CysK	COMPLEX	CYSSYNMULTI-CPLX
CysH	PROTEIN	PAPSSULFOTRANS-MONOMER
CysI	PROTEIN	BETACOMP-MONOMER
CysJ	PROTEIN	ALPHACOMP-MONOMER
CysJ-CysI	COMPLEX	SULFITE-REDUCT-CPLX
CysK	PROTEIN	ACSERLYA-MONOMER
CysM	PROTEIN	ACSERLYB-MONOMER
CysN	PROTEIN	CYSN-MONOMER
CysP	PROTEIN	CYSP-MONOMER
CysU	PROTEIN	CYST-MONOMER
CysW	PROTEIN	CYSW-MONOMER
DgcZ	PROTEIN	EG11643-MONOMER
H2SO4	SIMPLE_MOLECULE	SULFATE
H2SO4_Ext	SIMPLE_MOLECULE	SULFATE_Ext
HslJ	PROTEIN	G6702-MONOMER
L-glutamate	SIMPLE_MOLECULE	GLT
MOPS	SIMPLE_MOLECULE	CPD0-1958
PAPS	SIMPLE_MOLECULE	PAPS
RCHO	SIMPLE_MOLECULE	|Aldehydes|
Reduced FMN	SIMPLE_MOLECULE	FMNH2
Sbp	PROTEIN	SBP-MONOMER
Sbp-CysW-CysU-CysA	COMPLEX	ABC-70-CPLX
SsuA	PROTEIN	G6478-MONOMER
SsuA-SsuC-SsuB	COMPLEX	ABC-56-CPLX
SsuB	PROTEIN	YCBE-MONOMER
SsuC	PROTEIN	YCBM-MONOMER
SsuD	PROTEIN	MONOMER-162
SsuE	PROTEIN	MONOMER0-146
TauA	PROTEIN	TAUA-MONOMER
TauA-TauC-TauB	COMPLEX	ABC-64-CPLX
TauB	PROTEIN	TAUB-MONOMER
TauC	PROTEIN	TAUC-MONOMER
TauD	PROTEIN	MONOMER0-147
YbdN	PROTEIN	G6331-MONOMER
YciW	PROTEIN	G6640-MONOMER
YfbR	PROTEIN	G7185-MONOMER
YgeH	PROTEIN	G7472-MONOMER
YoaC	PROTEIN	G6994-MONOMER
acetate	SIMPLE_MOLECULE	ACET
acetylserine	SIMPLE_MOLECULE
acetylserine	SIMPLE_MOLECULE	ACETYLSERINE
adenylyl-sulfate	SIMPLE_MOLECULE	APS
alaA-yfbR	GENE
alaA-yfbR_mRNA	RNA
alanine	SIMPLE_MOLECULE	L-ALPHA-ALANINE
aliphatic sulfonate	SIMPLE_MOLECULE	|Aliphatic-Sulfonates|
aliphatic sulfonate_Ext	SIMPLE_MOLECULE	|Aliphatic-Sulfonates|_Ext
alkanesulfonate	SIMPLE_MOLECULE	|Alkanesulfonates|
aminoacetaldehyde	SIMPLE_MOLECULE	CPD-1772
butanal	SIMPLE_MOLECULE	BUTANAL
butanesulfonate	SIMPLE_MOLECULE	CPD-3744
c-di-GMP	SIMPLE_MOLECULE	C-DI-GMP
cbl	GENE
cbl_mRNA	RNA
cysB	GENE
cysB_mRNA	RNA
cysDNC	GENE
cysDNC_mRNA	RNA
cysJIH	GENE
cysJIH_mRNA	RNA
cysK	GENE
cysK_mRNA	RNA
cysPUWAM	GENE
cysPUWAM_mRNA	RNA
cysteine	SIMPLE_MOLECULE	CYS
d-cytidine	SIMPLE_MOLECULE	DEOXYCYTIDINE
dAMP	SIMPLE_MOLECULE	DAMP
dCMP	SIMPLE_MOLECULE	DCMP
dGMP	SIMPLE_MOLECULE	DGMP
dTMP	SIMPLE_MOLECULE	TMP
dUMP	SIMPLE_MOLECULE	DUMP
dehydroalanine	SIMPLE_MOLECULE	2-AMINOACRYLATE
deoxyadenosine	SIMPLE_MOLECULE	DEOXYADENOSINE
deoxyguanosine	SIMPLE_MOLECULE	DEOXYGUANOSINE
deoxynucleoside	SIMPLE_MOLECULE	|Deoxy-Ribonucleosides|
deoxynucleoside monophosphate	SIMPLE_MOLECULE	|Deoxy-Ribonucleoside-Monophosphates|
deoxyuridine	SIMPLE_MOLECULE	DEOXYURIDINE
dgcZ	GENE
dgcZ_mRNA	RNA
diphosphate	SIMPLE_MOLECULE	PPI
flavin mononucleotide	SIMPLE_MOLECULE	FMN
glycoaldehyde	SIMPLE_MOLECULE	GLYCOLALDEHYDE
guanosine-triphosphate	SIMPLE_MOLECULE	GTP
hslJ	GENE
hslJ_mRNA	RNA
isethionate	SIMPLE_MOLECULE	CPD-3745
ketoglutarate	SIMPLE_MOLECULE	2-KETOGLUTARATE
oxygen	SIMPLE_MOLECULE	OXYGEN-MOLECULE
phosphate	SIMPLE_MOLECULE	|Pi|
pyruvate	SIMPLE_MOLECULE	PYRUVATE
reduced riboflavin	SIMPLE_MOLECULE	CPD-316
reduced thioredoxin	SIMPLE_MOLECULE	|Red-Thioredoxin|
riboflavin	SIMPLE_MOLECULE	RIBOFLAVIN
selenate	SIMPLE_MOLECULE	SELENATE
selenate_Ext	SIMPLE_MOLECULE	SELENATE_Ext
selenite	SIMPLE_MOLECULE	SELENITE
selenite_Ext	SIMPLE_MOLECULE	SELENITE_Ext
ssuEADCB	GENE
ssuEADCB_mRNA	RNA
succinate	SIMPLE_MOLECULE	SUC
sulfide	SIMPLE_MOLECULE
sulfide	SIMPLE_MOLECULE	HS
sulfite	SIMPLE_MOLECULE	SO3
tauABCD	GENE
tauABCD_mRNA	RNA
taufon	SIMPLE_MOLECULE	TAURINE
taufon_Ext	SIMPLE_MOLECULE	TAURINE_Ext
thioredoxin disulfide	SIMPLE_MOLECULE	|Ox-Thioredoxin|
thiosulfate	SIMPLE_MOLECULE
thiosulfate	SIMPLE_MOLECULE	S2O3
thiosulfate_Ext	SIMPLE_MOLECULE	S2O3_Ext
thymidine	SIMPLE_MOLECULE	THYMIDINE
ybdN	GENE
ybdN_mRNA	RNA
yciW	GENE
yciW_mRNA	RNA
yfbR	GENE
yfbR_mRNA	RNA
ygeH	GENE
ygeH_mRNA	RNA
yoaC	GENE
yoaC_mRNA	RNA
