AdiA	PROTEIN	ARGDECARBOXDEG-MONOMER
AdiY	PROTEIN
CO2	SIMPLE_MOLECULE	CARBON-DIOXIDE
GABA	SIMPLE_MOLECULE	4-AMINO-BUTYRATE
GABA_Ext	SIMPLE_MOLECULE	4-AMINO-BUTYRATE_Ext
GadA	PROTEIN	GLUTDECARBOXA-MONOMER
GadB	PROTEIN	GLUTDECARBOXB-MONOMER
GadC	PROTEIN	XASA-MONOMER
GadX	PROTEIN	EG12243-MONOMER
GltB	PROTEIN	GLUSYNLARGE-MONOMER
GltD	PROTEIN	GLUSYNSMALL-MONOMER
GltD-GltB	COMPLEX	GLUTAMATESYN-DIMER
GltF	PROTEIN	EG11514-MONOMER
L-glutamate	SIMPLE_MOLECULE	GLT
L-glutamate_Ext	SIMPLE_MOLECULE	GLT_Ext
adiA	GENE
adiA_mRNA	RNA
agmatine	SIMPLE_MOLECULE	AGMATHINE
arginine	SIMPLE_MOLECULE	ARG
gadAX	GENE
gadAX_mRNA	RNA
gadBC	GENE
gadBC_mRNA	RNA
gltBDF	GENE
gltBDF_mRNA	RNA
