6-acetyl-beta-D-galactoside	SIMPLE_MOLECULE	|6-Acetyl-Beta-D-Galactosides|
LacA	PROTEIN	GALACTOACETYLTRAN-MONOMER
LacI	PROTEIN
LacI-allolactose	COMPLEX
LacY	PROTEIN	LACY-MONOMER
LacZ	PROTEIN	BETAGALACTOSID-MONOMER
acetyl-CoA	SIMPLE_MOLECULE	ACETYL-COA
allolactose	SIMPLE_MOLECULE
allolactose	SIMPLE_MOLECULE	ALLOLACTOSE
beta-D-galactoside	SIMPLE_MOLECULE	|Beta-D-Galactosides|
coenzyme A	SIMPLE_MOLECULE	CO-A
galactopyranose	SIMPLE_MOLECULE	|D-galactopyranose|
glucopyranose	SIMPLE_MOLECULE	|Glucopyranose|
lacZYA	GENE
lacZYA_mRNA	RNA
lactose	SIMPLE_MOLECULE	CPD-15972
lactose	SIMPLE_MOLECULE	|Alpha-lactose|
lactose_Ext	SIMPLE_MOLECULE	|Alpha-lactose|_Ext
melibiose	SIMPLE_MOLECULE	MELIBIOSE
melibiose_Ext	SIMPLE_MOLECULE	MELIBIOSE_Ext
