(2Z)-2-aminobut-2-enoate	SIMPLE_MOLECULE	CPD-15056
2-oxobutyrate	SIMPLE_MOLECULE	2-OXOBUTANOATE
TdcA	PROTEIN	PD00268
TdcB	PROTEIN	THREDEHYDCAT-MONOMER
TdcC	PROTEIN	TDCC-MONOMER
TdcD	PROTEIN	PROPKIN-MONOMER
TdcE	PROTEIN	KETOBUTFORMLY-INACT-MONOMER
TdcF	PROTEIN	G7626-MONOMER
TdcG	PROTEIN	LSERINEDEAM3-MONOMER
TdcR	PROTEIN
acetyl-CoA	SIMPLE_MOLECULE	ACETYL-COA
coenzyme A	SIMPLE_MOLECULE	CO-A
dehydroalanine	SIMPLE_MOLECULE	2-AMINOACRYLATE
formate	SIMPLE_MOLECULE	FORMATE
propanoate	SIMPLE_MOLECULE	PROPIONATE
propanoyl-CoA	SIMPLE_MOLECULE	PROPIONYL-COA
propanoyl-P	SIMPLE_MOLECULE	PROPIONYL-P
pyruvate	SIMPLE_MOLECULE	PYRUVATE
serine	SIMPLE_MOLECULE	SER
serine_Ext	SIMPLE_MOLECULE	SER_Ext
tdcABCDEFG	GENE
tdcABCDEFG_mRNA	RNA
threonine	SIMPLE_MOLECULE	THR
threonine_Ext	SIMPLE_MOLECULE	THR_Ext
