Cu(I)	SIMPLE_MOLECULE	CU+
Cu(I)_Ext	SIMPLE_MOLECULE	CU+_Ext
CusA	PROTEIN	YBDE-MONOMER
CusB	PROTEIN	G6322-MONOMER
CusC	PROTEIN	G6320-MONOMER
CusC-CusB-CusF-CusA	COMPLEX	CPLX0-1721
CusF	PROTEIN	G6321-MONOMER
CusR	PROTEIN
CusR-phosphate	COMPLEX
CusS	PROTEIN	G6318-MONOMER
CyoA	PROTEIN	CYOA-MONOMER
CyoB	PROTEIN	CYOB-MONOMER
CyoC	PROTEIN	CYOC-MONOMER
CyoD	PROTEIN	CYOD-MONOMER
CyoD-CyoA-CyoB-CyoC	COMPLEX	CYT-O-UBIOX-CPLX
CyoE	PROTEIN	HEMEOSYN-MONOMER
YedX	PROTEIN	G7058-MONOMER
cusCFBA	GENE
cusCFBA_mRNA	RNA
cusRS	GENE
cusRS_mRNA	RNA
cyoABCDE	GENE
cyoABCDE_mRNA	RNA
diphosphate	SIMPLE_MOLECULE	PPI
farnesyl-PP	SIMPLE_MOLECULE	FARNESYL-PP
ferroheme o	SIMPLE_MOLECULE	HEME_O
oxygen_Ext	SIMPLE_MOLECULE	OXYGEN-MOLECULE_Ext
phosphate	SIMPLE_MOLECULE
protoheme IX	SIMPLE_MOLECULE	|Heme-b|
silver	SIMPLE_MOLECULE	AG+
silver_Ext	SIMPLE_MOLECULE	AG+_Ext
ubiquinol_Ext	SIMPLE_MOLECULE	|Ubiquinols|_Ext
ubiquinone	SIMPLE_MOLECULE	|Ubiquinones|
yedX	GENE
yedX_mRNA	RNA
