MelA	PROTEIN	ALPHAGALACTOSID-MONOMER
MelB	PROTEIN	MELB-MONOMER
MelR	PROTEIN
MelR-melibiose	COMPLEX
Sodium	SIMPLE_MOLECULE	NA+
Sodium_Ext	SIMPLE_MOLECULE	NA+_Ext
a-methyl-D-galactoside	SIMPLE_MOLECULE	CPD-3565
a-methyl-D-galactoside_Ext	SIMPLE_MOLECULE	CPD-3565_Ext
b-methyl-D-galactoside	SIMPLE_MOLECULE	METHYL-BETA-D-GALACTOSIDE
b-methyl-D-galactoside_Ext	SIMPLE_MOLECULE	METHYL-BETA-D-GALACTOSIDE_Ext
galactopyranose	SIMPLE_MOLECULE	|D-galactopyranose|
glucopyranose	SIMPLE_MOLECULE	|Glucopyranose|
lithium ion	SIMPLE_MOLECULE	LI+
lithium ion_Ext	SIMPLE_MOLECULE	LI+_Ext
melAB	GENE
melAB_mRNA	RNA
melR	GENE
melR_mRNA	RNA
melibiose	SIMPLE_MOLECULE
melibiose	SIMPLE_MOLECULE	MELIBIOSE
melibiose_Ext	SIMPLE_MOLECULE	MELIBIOSE_Ext
