AlsA	PROTEIN	YJCW-MONOMER
AlsA-AlsC-AlsB	COMPLEX	ABC-42-CPLX
AlsB	PROTEIN	YJCX-MONOMER
AlsC	PROTEIN	YJCV-MONOMER
AlsE	PROTEIN	EG11957-MONOMER
AlsR	PROTEIN
AlsR-allose	COMPLEX
RpiB	PROTEIN	RIB5PISOMB-MONOMER
RpiR	PROTEIN	G7821-MONOMER
aldehydo-D-allose-6-P	SIMPLE_MOLECULE	D-ALLOSE-6-PHOSPHATE
allose	SIMPLE_MOLECULE
allose	SIMPLE_MOLECULE	ALLOSE
allose_Ext	SIMPLE_MOLECULE	ALLOSE_Ext
allulose-6-P	SIMPLE_MOLECULE	D-ALLULOSE-6-PHOSPHATE
fructose-6-P	SIMPLE_MOLECULE	FRUCTOSE-6P
ribose-5P	SIMPLE_MOLECULE	RIBOSE-5P
ribulose-5P	SIMPLE_MOLECULE	RIBULOSE-5P
rpiB	GENE
rpiB_mRNA	RNA
rpiR-alsBACE	GENE
rpiR-alsBACE_mRNA	RNA
