1-ethyladenine	SIMPLE_MOLECULE	1-ETHYLADENINE
1-methyladenine	SIMPLE_MOLECULE	N1-METHYLADENINE
3-methylcrotonyl-CoA	SIMPLE_MOLECULE	3-METHYL-CROTONYL-COA
Ada	PROTEIN
Ada-methyl	COMPLEX
AidB	PROTEIN	EG11811-MONOMER
AlkA	PROTEIN	EG11222-MONOMER
AlkB	PROTEIN	EG10037-MONOMER
CO2	SIMPLE_MOLECULE	CARBON-DIOXIDE
DNA 6-O-methylguanine	SIMPLE_MOLECULE	|DNA-6-O-Methyl-Guanines|
DNA guanine	SIMPLE_MOLECULE	|DNA-Guanines|
DNA(N)	SIMPLE_MOLECULE	DNA-N
DNA-base-CH3	SIMPLE_MOLECULE	|Methylated-DNA-Bases|
N3-methylcytosine	SIMPLE_MOLECULE	N3-METHYLCYTOSINE
[protein]-S-methyl-L-cysteine	SIMPLE_MOLECULE	|Protein-S-methyl-L-cysteine|
ada-alkB	GENE
ada-alkB_mRNA	RNA
adenine	SIMPLE_MOLECULE	ADENINE
aidB	GENE
aidB_mRNA	RNA
alkA	GENE
alkA_mRNA	RNA
alkylated DNA	SIMPLE_MOLECULE	|Alkylated-DNAs|
base(2)	SIMPLE_MOLECULE	|Alkylated-Bases|
cytosine	SIMPLE_MOLECULE	CYTOSINE
ethanal	SIMPLE_MOLECULE	ACETALD
formol	SIMPLE_MOLECULE	FORMALDEHYDE
isovaleryl-CoA	SIMPLE_MOLECULE	ISOVALERYL-COA
ketoglutarate	SIMPLE_MOLECULE	2-KETOGLUTARATE
methyl	SIMPLE_MOLECULE
nucleobase within DNA	SIMPLE_MOLECULE	|Nucleobases-in-DNA|
oxidized ETF	SIMPLE_MOLECULE	|ETF-Oxidized|
oxygen	SIMPLE_MOLECULE	OXYGEN-MOLECULE
peptide cysteine	SIMPLE_MOLECULE	PROT-CYS
reduced ETF	SIMPLE_MOLECULE	|ETF-Reduced|
succinate	SIMPLE_MOLECULE	SUC
