C4-dicarboxylate	SIMPLE_MOLECULE	|C4-dicarboxylates|
C4-dicarboxylate_Ext	SIMPLE_MOLECULE	|C4-dicarboxylates|_Ext
DctA	PROTEIN	DCTA-MONOMER
DcuB	PROTEIN	DCUB-MONOMER
DcuR	PROTEIN
DcuR-phosphate	COMPLEX
DpiA	PROTEIN	G6346-MONOMER
DpiB	PROTEIN	G6345-MONOMER
FrdA	PROTEIN	FUM-FLAVO
FrdA-FrdB-FrdC-FrdD	COMPLEX	FUMARATE-REDUCTASE
FrdB	PROTEIN	FUM-FE-S
FrdC	PROTEIN	FUM-MEMB1
FrdD	PROTEIN	FUM-MEMB2
FumB	PROTEIN	FUMB-MONOMER
aspartate	SIMPLE_MOLECULE	L-ASPARTATE
aspartate_Ext	SIMPLE_MOLECULE	L-ASPARTATE_Ext
dctA	GENE
dctA_mRNA	RNA
dcuB-fumB	GENE
dcuB-fumB_mRNA	RNA
dpiBA	GENE
dpiBA_mRNA	RNA
frdABCD	GENE
frdABCD_mRNA	RNA
fumarate	SIMPLE_MOLECULE	FUM
fumarate_Ext	SIMPLE_MOLECULE	FUM_Ext
malate	SIMPLE_MOLECULE	CPD-660
malate	SIMPLE_MOLECULE	MAL
malate_Ext	SIMPLE_MOLECULE	CPD-660_Ext
malate_Ext	SIMPLE_MOLECULE	MAL_Ext
menaquinol	SIMPLE_MOLECULE	|Menaquinols|
orotate	SIMPLE_MOLECULE	OROTATE
orotate_Ext	SIMPLE_MOLECULE	OROTATE_Ext
oxalacetate	SIMPLE_MOLECULE	OXALACETIC_ACID
phosphate	SIMPLE_MOLECULE
succinate	SIMPLE_MOLECULE	SUC
succinate_Ext	SIMPLE_MOLECULE	SUC_Ext
tartrate	SIMPLE_MOLECULE	D-TARTRATE
tartrate_Ext	SIMPLE_MOLECULE	D-TARTRATE_Ext
vitamin K2	SIMPLE_MOLECULE	|Menaquinones|
