2,4-DNP	SIMPLE_MOLECULE
2-HBA	SIMPLE_MOLECULE
MarA	PROTEIN	PD00365
MarB	PROTEIN	EG11599-MONOMER
MarR	PROTEIN
MarR-2,4-DNP	COMPLEX
MarR-2-HBA	COMPLEX
MarR-benzoate	COMPLEX
MarR-menadione	COMPLEX
MarR-paraquat	COMPLEX
MarR-phenazine methosulfate	COMPLEX
MarR-plumbagin	COMPLEX
MarR-sodium salicylate	COMPLEX
benzoate	SIMPLE_MOLECULE
marRAB	GENE
marRAB_mRNA	RNA
menadione	SIMPLE_MOLECULE
paraquat	SIMPLE_MOLECULE
phenazine methosulfate	SIMPLE_MOLECULE
plumbagin	SIMPLE_MOLECULE
sodium salicylate	SIMPLE_MOLECULE
