(2E)-dec-2-enoyl-[acp]	SIMPLE_MOLECULE	|Trans-D2-decenoyl-ACPs|
(2E)-dodec-2-enoyl-[acp]	SIMPLE_MOLECULE	|Dodec-2-enoyl-ACPs|
(2E,11Z)-octadeca-2,11-dienoyl-[acp]	SIMPLE_MOLECULE	|cis-vaccen-2-enoyl-ACPs|
(3R)-3-hydroxy cis delta7-tetradecenoyl-[acp]	SIMPLE_MOLECULE	|3-hydroxy-cis-D7-tetraecenoyl-ACPs|
(3R)-3-hydroxy cis delta9-hexadecenoyl-[acp]	SIMPLE_MOLECULE	|3-hydroxy-cis-D9-hexaecenoyl-ACPs|
(3R)-3-hydroxy-cis-vaccenoyl-[acp]	SIMPLE_MOLECULE	|R-3-hydroxy-cis-vaccenoyl-ACPs|
(3R)-3-hydroxyglutaryl-[acp] methyl ester	SIMPLE_MOLECULE	|3-Hydroxyglutaryl-ACP-methyl-ester|
3-hydroxypimeloyl-[acp] methyl ester	SIMPLE_MOLECULE	|3-hydroxypimeloyl-ACP-methyl-esters|
5-methylthioribose	SIMPLE_MOLECULE	CPD-560
5-methylthioribose_Ext	SIMPLE_MOLECULE	CPD-560_Ext
AcpP	SIMPLE_MOLECULE	ACP
AcpP	SIMPLE_MOLECULE	|Beta-3-hydroxybutyryl-ACPs|
AcpP	SIMPLE_MOLECULE	|R-3-Hydroxypalmitoyl-ACPs|
AcpP	SIMPLE_MOLECULE	|Trans-D3-cis-D5-dodecenoyl-ACPs|
AcpP	SIMPLE_MOLECULE	|b-Hydroxy-cis-D5-dodecenoyl-ACPs|
AcrA	PROTEIN	EG11703-MONOMER
AcrD	PROTEIN	ACRD-MONOMER
AcrD-AcrA-TolC	COMPLEX	CPLX0-3932
AroG	PROTEIN	AROG-MONOMER
BacA	PROTEIN	EG11665-MONOMER
BaeR	PROTEIN	BAER-MONOMER
BaeS	PROTEIN	BAES-MONOMER
BamA	PROTEIN	G6093-MONOMER
BamB	PROTEIN	G7320-MONOMER
BamC	PROTEIN	EG10658-MONOMER
BamD	PROTEIN	G7352-MONOMER
BamE	PROTEIN	EG10952-MONOMER
BamE-BamC-BamD-BamA-BamB	COMPLEX	CPLX0-3933
C4-dicarboxylate	SIMPLE_MOLECULE	|C4-dicarboxylates|
C4-dicarboxylate_Ext	SIMPLE_MOLECULE	|C4-dicarboxylates|_Ext
CH3(CH2)xCH=CHCO-S-ACP	SIMPLE_MOLECULE	TRANS-D2-ENOYL-ACP
CO2	SIMPLE_MOLECULE	CARBON-DIOXIDE
CO2_Ext	SIMPLE_MOLECULE	CARBON-DIOXIDE_Ext
CheA	PROTEIN	CHEA-SMALL
CheA	PROTEIN	PROTEIN-CHEA
CheA-CheW-Tap	COMPLEX	TAP-CPLX
CheA-CheW-Tar	COMPLEX	TAR-CPLX
CheA-CheW-Trg	COMPLEX	TRG-CPLX
CheW	PROTEIN	CHEW-MONOMER
CheW-CheA-Tsr	COMPLEX	TSR-CPLX
CpxA	PROTEIN	CPXA-MONOMER
CpxP	PROTEIN	G7816-MONOMER
CpxR	PROTEIN
CpxR-phosphate	COMPLEX
CsgA	PROTEIN	EG11489-MONOMER
CsgA	SIMPLE_MOLECULE	EG11489-MONOMER
CsgA_Ext	SIMPLE_MOLECULE	EG11489-MONOMER_Ext
CsgB	PROTEIN	G6547-MONOMER
CsgC	PROTEIN	G6548-MONOMER
CsgD	PROTEIN	PD01379
CsgE	PROTEIN	G6545-MONOMER
CsgE-CsgG	COMPLEX	CPLX-3945
CsgF	PROTEIN	G6544-MONOMER
CsgG	PROTEIN	G6543-MONOMER
DAHP	SIMPLE_MOLECULE	3-DEOXY-D-ARABINO-HEPTULOSONATE-7-P
DNA	SIMPLE_MOLECULE	|DNA-Holder|
DNA containing an apyrimidinic site	SIMPLE_MOLECULE	|DNA-containing-a-Apyrimidinic-Sites|
DNA with lesion	SIMPLE_MOLECULE	CPD-8180
DNA with lesion resolved through Rec-mediated pathway	SIMPLE_MOLECULE	CPD-8181
DNA with uracil	SIMPLE_MOLECULE	|DNA-with-Uracils|
DNA(N)	SIMPLE_MOLECULE	DNA-N
DegP	PROTEIN	EG10463-MONOMER
DgcZ	PROTEIN	EG11643-MONOMER
DnaE	PROTEIN	EG10238-MONOMER
DnaE-DnaQ-HolE	COMPLEX	CPLX0-2361
DnaQ	PROTEIN	EG10243-MONOMER
DsbA	PROTEIN	DISULFOXRED-MONOMER
DsbC	PROTEIN	CPLX0-8002
EfeB	PROTEIN	EG11735-MONOMER
EfeO	PROTEIN	G6527-MONOMER
EfeU_1	PROTEIN	G6525-MONOMER
EfeU_1-EfeO-EfeB	COMPLEX	CPLX0-7644
FabZ	PROTEIN	FABZ-MONOMER
FlgB	PROTEIN	FLGB-FLAGELLAR-MOTOR-ROD-PROTEIN
FlgC	PROTEIN	FLGC-FLAGELLAR-MOTOR-ROD-PROTEIN
FlgF	PROTEIN	FLGF-FLAGELLAR-MOTOR-ROD-PROTEIN
FlgG	PROTEIN	FLGG-FLAGELLAR-MOTOR-ROD-PROTEIN
FlgH	PROTEIN	FLGH-FLAGELLAR-L-RING
FlgI	PROTEIN	FLGI-FLAGELLAR-P-RING
FliE	PROTEIN	EG11346-MONOMER
FliF	PROTEIN	FLIF-FLAGELLAR-MS-RING
FliG	PROTEIN	FLIG-FLAGELLAR-SWITCH-PROTEIN
FliL	PROTEIN	EG10322-MONOMER
FliM	PROTEIN	FLIM-FLAGELLAR-C-RING-SWITCH
FliN	PROTEIN	FLIN-FLAGELLAR-C-RING-SWITCH
FliN-FliM-FliG-FlgH-MotA-MotB-FlgB-FlgC-FlgF-FlgG-FlgI-FliF-FliE-FliL	COMPLEX	FLAGELLAR-MOTOR-COMPLEX
FtnB	PROTEIN	G7033-MONOMER
GlcNAc-1,6-anhydro-MurNAc-pentapeptide	SIMPLE_MOLECULE	|GlcNAc-1-6-anhydro-MurNAc-pentapeptide|
Hha	PROTEIN	EG10439-MONOMER
HolE	PROTEIN	EG11505-MONOMER
LYSYL-TRNA(LYS)	SIMPLE_MOLECULE	|Charged-LYS-tRNAs|
LdtC	PROTEIN	G6571-MONOMER
LpxA	PROTEIN	UDPNACETYLGLUCOSAMACYLTRANS-MONOMER
LpxB	PROTEIN	LIPIDADISACCHARIDESYNTH-MONOMER
LpxD	PROTEIN	UDPHYDROXYMYRGLUCOSAMNACETYLTRANS-MONO
LysS	PROTEIN	LYSS-MONOMER
MarA	PROTEIN	PD00365
MarB	PROTEIN	EG11599-MONOMER
MarR	PROTEIN	PD00364
MdtA	PROTEIN	MDTA
MdtB	PROTEIN	B2075-MONOMER
MdtC	PROTEIN	B2076-MONOMER
MdtD	PROTEIN	B2077-MONOMER
MlpA	SIMPLE_MOLECULE	EG10544-MONOMER
MotA	PROTEIN	MOTA-FLAGELLAR-MOTOR-STATOR-PROTEIN
MotB	PROTEIN	MOTB-FLAGELLAR-MOTOR-STATOR-PROTEIN
MscM	PROTEIN	G7840-MONOMER
MzrA	PROTEIN	G7610-MONOMER
N-acetylneuraminate	SIMPLE_MOLECULE	N-ACETYLNEURAMINATE
N-acetylneuraminate_Ext	SIMPLE_MOLECULE	N-ACETYLNEURAMINATE_Ext
NP	PROTEIN	:error
OmpC	PROTEIN	EG10670-MONOMER
OmpF	PROTEIN	EG10671-MONOMER
P-enol-pyruvate	SIMPLE_MOLECULE	PHOSPHO-ENOL-PYRUVATE
Peptide Antibiotic	SIMPLE_MOLECULE	|Peptide-Antibiotics|
Peptide Antibiotic_Ext	SIMPLE_MOLECULE	|Peptide-Antibiotics|_Ext
PpiA	PROTEIN	EG10757-MONOMER
PpiD	PROTEIN	G6242-MONOMER
PrfB	PROTEIN	EG10762-MONOMER
Psd	PROTEIN	PHOSPHASERDECARB-ALPHA-MONOMER
Psd	PROTEIN	PHOSPHASERDECARB-BETA-MONOMER
Psd	PROTEIN	PSD-MONOMER
Psd-Psd	COMPLEX	PHOSPHASERDECARB-DIMER
RNA-DNA hybrid	SIMPLE_MOLECULE	|RNA-DNA-hybrids|
RNA:CyaR	PROTEIN	RYEE-RNA
RNA:RprA	PROTEIN	RPRA-RNA
RdoA	PROTEIN	EG11831-MONOMER
RecJ	PROTEIN	EG10830-MONOMER
RnhB	PROTEIN	EG10861-MONOMER
RpoA	PROTEIN	EG10893-MONOMER
RpoB	PROTEIN	RPOB-MONOMER
RpoB-RpoC-RpoA-RpoE	COMPLEX	RNAPE-CPLX
RpoB-RpoC-RpoA-RpoH	COMPLEX	RNAP32-CPLX
RpoC	PROTEIN	RPOC-MONOMER
RpoE	PROTEIN	RPOE-MONOMER
RpoH	PROTEIN	RPOH-MONOMER
RseA	PROTEIN	EG12341-MONOMER
RseB	PROTEIN	CPLX0-7648
RseC	PROTEIN	G7347-MONOMER
SbmA	PROTEIN	SBMA-MONOMER
Skp	PROTEIN	EG10455-MONOMER
Slt	PROTEIN	EG10950-MONOMER
Spy	PROTEIN	G6939-MONOMER
TRNA(LYS)	SIMPLE_MOLECULE	|LYS-tRNAs|
Tap	PROTEIN	TAP-MONOMER
Tar	PROTEIN	TAR-MONOMER
TolB	PROTEIN	EG11008-MONOMER
TolB-OmpF	COMPLEX	CPLX0-2221
TolC	PROTEIN	EG11009-MONOMER
TolC-MdtC-MdtB-MdtA	COMPLEX	TRANS-CPLX-202
TomB	PROTEIN	EG12429-MONOMER
Trg	PROTEIN	TRG-MONOMER
Tsr	PROTEIN	TSR-MONOMER
UDP-2,3-diacyl-glucosamine	SIMPLE_MOLECULE	OH-MYRISTOYL
UDP-3-O-(3-hydroxymyristoyl)-N-acetylglucosamine	SIMPLE_MOLECULE	UDP-OHMYR-ACETYLGLUCOSAMINE
UDP-3-O-(3-hydroxytetradecanoyl)glucosamine	SIMPLE_MOLECULE	UDP-OHMYR-GLUCOSAMINE
UDP-GlcNAc	SIMPLE_MOLECULE	UDP-N-ACETYL-D-GLUCOSAMINE
UPP (ambiguous)	SIMPLE_MOLECULE	UNDECAPRENYL-DIPHOSPHATE
Ung	PROTEIN	EG11058-MONOMER
XerC	PROTEIN	EG11069-MONOMER
XerC-XerD	COMPLEX	CPLX0-3959
XerD	PROTEIN	EG11071-MONOMER
YaiW	PROTEIN	G6227-MONOMER
YccA	PROTEIN	EG11113-MONOMER
YebE	PROTEIN	EG11806-MONOMER
YgaU	PROTEIN	G7395-MONOMER
YidQ	PROTEIN	EG11712-MONOMER
YqaE	PROTEIN	G7396-MONOMER
YqjA	PROTEIN	G7609-MONOMER
[protein] (L-serine/L-threonine) phosphate	SIMPLE_MOLECULE	|Protein-Ser-or-Thr-phosphate|
[protein]-L-serine/L-threonine	SIMPLE_MOLECULE	|Protein-L-serine-or-L-threonine|
acrD	GENE
acrD_mRNA	RNA
ala	SIMPLE_MOLECULE	D-ALANINE
amino acid	SIMPLE_MOLECULE	|Amino-Acids|
amino acid_Ext	SIMPLE_MOLECULE	|Amino-Acids|_Ext
aroG	GENE
aroG_mRNA	RNA
bacA	GENE
bacA_mRNA	RNA
bamA-skp-lpxD-fabZ-lpxAB-rnhB-dnaE	GENE
bamA-skp-lpxD-fabZ-lpxAB-rnhB-dnaE_mRNA	RNA
bamE	GENE
bamE_mRNA	RNA
base(2)	SIMPLE_MOLECULE	|Bases|
base(2)_Ext	SIMPLE_MOLECULE	|Bases|_Ext
beta-Neu5Ac	SIMPLE_MOLECULE	CPD0-1123
beta-Neu5Ac_Ext	SIMPLE_MOLECULE	CPD0-1123_Ext
beta-OH-acyl-ACP	SIMPLE_MOLECULE	OH-ACYL-ACP
beta-hydroxydecanoyl-[acp]	SIMPLE_MOLECULE	|Beta-hydroxydecanoyl-ACPs|
beta-hydroxydodecanoyl-[acp]	SIMPLE_MOLECULE	|R-3-hydroxydodecanoyl-ACPs|
beta-hydroxyhexanoyl-[acp]	SIMPLE_MOLECULE	|R-3-hydroxyhexanoyl-ACPs|
beta-hydroxymyristoyl-[acp]	SIMPLE_MOLECULE	|R-3-hydroxymyristoyl-ACPs|
betaine	SIMPLE_MOLECULE	BETAINE
betaine_Ext	SIMPLE_MOLECULE	BETAINE_Ext
c-di-GMP	SIMPLE_MOLECULE	C-DI-GMP
cpxP	GENE
cpxP_mRNA	RNA
cpxRA	GENE
cpxRA_mRNA	RNA
crotonyl-[acp]	SIMPLE_MOLECULE	|Crotonyl-ACPs|
csgBAC	GENE
csgBAC_mRNA	RNA
csgDEFG	GENE
csgDEFG_mRNA	RNA
cyaR	GENE
cyaR_mRNA	RNA
degP	GENE
degP_mRNA	RNA
deoxynucleoside triphosphate	SIMPLE_MOLECULE	|Deoxy-Ribonucleoside-Triphosphates|
dgcZ	GENE
dgcZ_mRNA	RNA
diphosphate	SIMPLE_MOLECULE	PPI
ditrans,polycis-undecaprenyl phosphate	SIMPLE_MOLECULE	CPD-9646
drug	SIMPLE_MOLECULE	|Drugs|
drug_Ext	SIMPLE_MOLECULE	|Drugs|_Ext
dsbC	GENE
dsbC_mRNA	RNA
efeU_1U_2	GENE
efeU_1U_2_mRNA	RNA
enoylglutaryl-[acp] methyl ester	SIMPLE_MOLECULE	|Enoylglutaryl-ACP-methyl-esters|
enoylpimelyl-[acp] methyl ester	SIMPLE_MOLECULE	|Enoylpimeloyl-ACP-methyl-esters|
erythrose-4P	SIMPLE_MOLECULE	ERYTHROSE-4P
ftnB	GENE
ftnB_mRNA	RNA
glycine	SIMPLE_MOLECULE	GLY
guanosine-triphosphate	SIMPLE_MOLECULE	GTP
hydrophilic solute or ion 600 Da	SIMPLE_MOLECULE	|Hydrophilic-Solute-Or-Ion-LT-600Da|
hydrophilic solute or ion 600 Da_Ext	SIMPLE_MOLECULE	|Hydrophilic-Solute-Or-Ion-LT-600Da|_Ext
inositol	SIMPLE_MOLECULE	|Inositols|
inositol_Ext	SIMPLE_MOLECULE	|Inositols|_Ext
ion	SIMPLE_MOLECULE	|Ions|
ion_Ext	SIMPLE_MOLECULE	|Ions|_Ext
ldtC	GENE
ldtC_mRNA	RNA
lipid A disaccharide	SIMPLE_MOLECULE	BISOHMYR-GLC
lipid II	SIMPLE_MOLECULE	|NAcMur-Peptide-NAcGlc-Undecaprenols|
lipid X	SIMPLE_MOLECULE	BISOHMYR-GLUCOSAMINYL-1P
lysine	SIMPLE_MOLECULE	LYS
marRAB	GENE
marRAB_mRNA	RNA
mdtABCD-baeSR	GENE
mdtABCD-baeSR_mRNA	RNA
mononucleotide	SIMPLE_MOLECULE	|Nucleoside-Monophosphates|
monosaccharide	SIMPLE_MOLECULE	|Monosaccharides|
monosaccharide_Ext	SIMPLE_MOLECULE	|Monosaccharides|_Ext
motAB-cheAW	GENE
motAB-cheAW_mRNA	RNA
nascent peptidoglycan with (L-alanyl-gamma-D-glutamyl-meso-2,6-diaminopimelate) tripeptide	SIMPLE_MOLECULE	CPD-17968
nascent peptidoglycan with (L-alanyl-gamma-D-glutamyl-meso-2,6-diaminopimeloyl-D-alanine) tetrapeptide	SIMPLE_MOLECULE	CPD-17926
nascent peptidoglycan with (L-alanyl-gamma-D-glutamyl-meso-2,6-diaminopimeloyl-glycine) tetrapeptide	SIMPLE_MOLECULE	CPD-17969
ompC	GENE
ompC_mRNA	RNA
ompF	GENE
ompF_mRNA	RNA
organosulfur compound	SIMPLE_MOLECULE	ORGANOSULFUR
organosulfur compound_Ext	SIMPLE_MOLECULE	ORGANOSULFUR_Ext
peptide	SIMPLE_MOLECULE	|Peptides-holder|
peptidoglycan dimer (generic)	SIMPLE_MOLECULE	|Peptidoglycan-dimer|
peptidoglycan tripeptide-Lpp crosslink	SIMPLE_MOLECULE	CPD0-1171
peptidoglycan with (L-alanyl-gamma-D-glutamyl-meso-2,6-diaminopimeloyl-D-alanine) tetrapeptide	SIMPLE_MOLECULE	CPD-17931
peptidylproline (omega = 0)	SIMPLE_MOLECULE	CPD-8625
peptidylproline (omega = 180)	SIMPLE_MOLECULE	CPD-8624
phosphate	SIMPLE_MOLECULE
phosphate	SIMPLE_MOLECULE	|Pi|
polyol	SIMPLE_MOLECULE	|Sugar-alcohols|
polyol_Ext	SIMPLE_MOLECULE	|Sugar-alcohols|_Ext
ppiA	GENE
ppiA_mRNA	RNA
ppiD	GENE
ppiD_mRNA	RNA
protein	SIMPLE_MOLECULE	|General-Protein-Substrates|
protein with correct disulfide bonds	SIMPLE_MOLECULE	|Proteins-with-correct-disulfides|
protein with incorrect disulfide bonds	SIMPLE_MOLECULE	|Proteins-with-incorrect-disulfides|
protein with oxidized disulfide bonds	SIMPLE_MOLECULE	|Protein-Ox-Disulfides|
protein with reduced SH groups	SIMPLE_MOLECULE	|Protein-Red-Disulfides|
psd-mscM	GENE
psd-mscM_mRNA	RNA
rdoA-dsbA	GENE
rdoA-dsbA_mRNA	RNA
rpoE-rseABC	GENE
rpoE-rseABC_mRNA	RNA
rpoH	GENE
rpoH_mRNA	RNA
rprA	GENE
rprA_mRNA	RNA
sbmA-yaiW	GENE
sbmA-yaiW_mRNA	RNA
short-chain acid anion	SIMPLE_MOLECULE	|Short-Chain-Carboxylates|
short-chain acid anion_Ext	SIMPLE_MOLECULE	|Short-Chain-Carboxylates|_Ext
short-chain alcohol	SIMPLE_MOLECULE	|Short-Chain-Alcohols|
short-chain alcohol_Ext	SIMPLE_MOLECULE	|Short-Chain-Alcohols|_Ext
skp-lpxD-fabZ-lpxA	GENE
skp-lpxD-fabZ-lpxA_mRNA	RNA
slt	GENE
slt_mRNA	RNA
spy	GENE
spy_mRNA	RNA
tomB-hha	GENE
tomB-hha_mRNA	RNA
trans hex-2-enoyl-[acp]	SIMPLE_MOLECULE	|Hex-2-enoyl-ACPs|
trans hexadecenoyl-[acp]	SIMPLE_MOLECULE	|2-Hexadecenoyl-ACPs|
trans tetradec-2-enoyl-[acp]	SIMPLE_MOLECULE	|Tetradec-2-enoyl-ACPs|
trans-delta3-cis-delta7-tetradecenoyl-[acp]	SIMPLE_MOLECULE	|Trans-D3-cis-D7-tetradecenoyl-ACPs|
trans-delta3-cis-delta9-hexadecenoyl-[acp]	SIMPLE_MOLECULE	|Trans-D3-cis-D9-hexadecenoyl-ACPs|
tsr	GENE
tsr_mRNA	RNA
ung	GENE
ung_mRNA	RNA
uracil	SIMPLE_MOLECULE	URACIL
uridine-diphosphate	SIMPLE_MOLECULE	UDP
xerD-dsbC-recJ-prfB-lysS	GENE
xerD-dsbC-recJ-prfB-lysS_mRNA	RNA
yccA	GENE
yccA_mRNA	RNA
yebE	GENE
yebE_mRNA	RNA
ygaU	GENE
ygaU_mRNA	RNA
yidQ	GENE
yidQ_mRNA	RNA
yqaE	GENE
yqaE_mRNA	RNA
yqjA-mzrA	GENE
yqjA-mzrA_mRNA	RNA
