AlaC	PROTEIN	G7242-MONOMER
L-glutamate	SIMPLE_MOLECULE	GLT
RNA:SgrS	PROTEIN	RNA0-241
RNA:SroA	PROTEIN	RNA0-122
SetA	PROTEIN	B0070-MONOMER
SgrR	PROTEIN	EG12094-MONOMER
SgrT	PROTEIN	MONOMER0-2842
TbpA	PROTEIN	SFUA-MONOMER
ThiP	PROTEIN	SFUB-MONOMER
ThiQ	PROTEIN	SFUC-MONOMER
ThiQ-ThiP-TbpA	COMPLEX	ABC-32-CPLX
alaC	GENE
alaC_mRNA	RNA
alanine	SIMPLE_MOLECULE	L-ALPHA-ALANINE
ketoglutarate	SIMPLE_MOLECULE	2-KETOGLUTARATE
lactose	SIMPLE_MOLECULE	|Alpha-lactose|
lactose_Ext	SIMPLE_MOLECULE	|Alpha-lactose|_Ext
pyruvate	SIMPLE_MOLECULE	PYRUVATE
sgrR-sroA-tbpA-thiPQ	GENE
sgrR-sroA-tbpA-thiPQ_mRNA	RNA
sgrST-setA	GENE
sgrST-setA_mRNA	RNA
thiamin	SIMPLE_MOLECULE	THIAMINE
thiamin_Ext	SIMPLE_MOLECULE	THIAMINE_Ext
