NhaA	PROTEIN	NHAA-MONOMER
NhaR	PROTEIN
NhaR-Sodium	COMPLEX
OsmC	PROTEIN	EG10680-MONOMER
PgaA	PROTEIN	G6531-MONOMER
PgaB	PROTEIN	G6530-MONOMER
PgaC	PROTEIN	G6529-MONOMER
PgaD	PROTEIN	G6528-MONOMER
PgaD-PgaC	COMPLEX	CPLX0-7994
ROOH	SIMPLE_MOLECULE	|Alkyl-Hydro-Peroxides|
Sodium	SIMPLE_MOLECULE
Sodium	SIMPLE_MOLECULE	NA+
Sodium_Ext	SIMPLE_MOLECULE	NA+_Ext
UDP-GlcNAc	SIMPLE_MOLECULE	UDP-N-ACETYL-D-GLUCOSAMINE
acetate	SIMPLE_MOLECULE	ACET
alcohol	SIMPLE_MOLECULE	|Alcohols|
nhaAR	GENE
nhaAR_mRNA	RNA
osmC	GENE
osmC_mRNA	RNA
partially N-deacetylated poly-beta-1,6-N-acetyl-D-glucosamine	SIMPLE_MOLECULE	CPD0-1193
partially N-deacetylated poly-beta-1,6-N-acetyl-D-glucosamine_Ext	SIMPLE_MOLECULE	CPD0-1193_Ext
pgaABCD	GENE
pgaABCD_mRNA	RNA
poly-beta-1,6-N-acetyl-D-glucosamine	SIMPLE_MOLECULE	CPD0-1192
poly-beta-1,6-N-acetyl-D-glucosamine_Ext	SIMPLE_MOLECULE	CPD0-1192_Ext
reduced thioredoxin	SIMPLE_MOLECULE	|Red-Thioredoxin|
thioredoxin disulfide	SIMPLE_MOLECULE	|Ox-Thioredoxin|
uridine-diphosphate	SIMPLE_MOLECULE	UDP
