Cadmium	SIMPLE_MOLECULE
Cu(II)	SIMPLE_MOLECULE
NikA	PROTEIN	NIKA-MONOMER
NikB	PROTEIN	NIKB-MONOMER
NikC	PROTEIN	NIKC-MONOMER
NikD	PROTEIN	NIKD-MONOMER
NikD-NikE-NikB-NikC-NikA	COMPLEX	ABC-20-CPLX
NikE	PROTEIN	NIKE-MONOMER
NikR	PROTEIN
NikR-Cadmium	COMPLEX
NikR-Cu(II)	COMPLEX
NikR-Zinc	COMPLEX
NikR-cobalt ion	COMPLEX
NikR-nickel	COMPLEX
Zinc	SIMPLE_MOLECULE
cobalt ion	SIMPLE_MOLECULE
nickel	SIMPLE_MOLECULE
nickel	SIMPLE_MOLECULE	NI+2
nickel_Ext	SIMPLE_MOLECULE	NI+2_Ext
nikABCDER	GENE
nikABCDER_mRNA	RNA
