FimB	PROTEIN	EG10309-MONOMER
ManNAc-6-P	SIMPLE_MOLECULE	N-ACETYL-D-MANNOSAMINE-6P
N-acetyl-alpha-D-glucosamine 6-phosphate	SIMPLE_MOLECULE	N-ACETYL-D-GLUCOSAMINE-6-P
N-acetyl-beta-D-mannosamine	SIMPLE_MOLECULE	N-ACETYL-D-MANNOSAMINE
N-acetyl-beta-D-mannosamine	SIMPLE_MOLECULE	|N-acetyl-D-mannosamine|
N-acetylneuraminate	SIMPLE_MOLECULE
N-acetylneuraminate	SIMPLE_MOLECULE	N-ACETYLNEURAMINATE
N-acetylneuraminate_Ext	SIMPLE_MOLECULE	N-ACETYLNEURAMINATE_Ext
NanA	PROTEIN	ACNEULY-MONOMER
NanC	PROTEIN	G7921-MONOMER
NanE	PROTEIN	NANE-MONOMER
NanK	PROTEIN	NANK-MONOMER
NanM	PROTEIN	G7920-MONOMER
NanR	PROTEIN
NanR-N-acetylneuraminate	COMPLEX
NanS	PROTEIN	G7919-MONOMER
NanT	PROTEIN	NANT-MONOMER
YhcH	PROTEIN	G7675-MONOMER
YjhB	PROTEIN	YJHB-MONOMER
YjhC	PROTEIN	G7901-MONOMER
alpha-Neu5Ac	SIMPLE_MOLECULE	CPD0-1122
beta-Neu5Ac	SIMPLE_MOLECULE	CPD0-1123
beta-Neu5Ac_Ext	SIMPLE_MOLECULE	CPD0-1123_Ext
fimB	GENE
fimB_mRNA	RNA
nanA	GENE
nanATEK-yhcH	GENE
nanATEK-yhcH_mRNA	RNA
nanA_mRNA	RNA
nanCM	GENE
nanCMS	GENE
nanCMS_mRNA	RNA
nanCM_mRNA	RNA
pyruvate	SIMPLE_MOLECULE	PYRUVATE
yjhBC	GENE
yjhBC_mRNA	RNA
