1,2-propanediol	SIMPLE_MOLECULE	PROPANE-1-2-DIOL
1,3,4-butanetriol	SIMPLE_MOLECULE	CPD-16716
1,3-propanediol	SIMPLE_MOLECULE	CPD-347
2,5-diketo-D-gluconate	SIMPLE_MOLECULE	25-DIDEHYDRO-D-GLUCONATE
3,4-dihydroxybutanal	SIMPLE_MOLECULE	CPD0-2582
3-hydroxypropanal	SIMPLE_MOLECULE	HYDROXYPROPANAL
DkgA	PROTEIN	MONOMER0-148
RCHO	SIMPLE_MOLECULE	|Aldehydes|
YqhC	PROTEIN
YqhD	PROTEIN	G7564-MONOMER
acetate	SIMPLE_MOLECULE	ACET
acetol	SIMPLE_MOLECULE	ACETOL
alcohol	SIMPLE_MOLECULE	|Alcohols|
carboxylate	SIMPLE_MOLECULE	|Carboxylates|
ethanal	SIMPLE_MOLECULE	ACETALD
ethyl-(2R)-methyl-(3S)-hydroxybutanoate	SIMPLE_MOLECULE	ETHYL-2R-METHYL-3S-HYDROXYBUTANOATE
ethyl-2-methylacetoacetate	SIMPLE_MOLECULE	ETHYL-2-METHYLACETOACETATE
isobutanal	SIMPLE_MOLECULE	CPD-7000
isobutanol	SIMPLE_MOLECULE	ISOBUTANOL
lactaldehyde	SIMPLE_MOLECULE	LACTALD
oxopropanal	SIMPLE_MOLECULE	METHYL-GLYOXAL
sorbosonate	SIMPLE_MOLECULE	CPD-13059
yqhD-dkgA	GENE
yqhD-dkgA_mRNA	RNA
