5'-deoxyadenosine	SIMPLE_MOLECULE	CH33ADO
AcpP	SIMPLE_MOLECULE	ACP
BioA	PROTEIN	DAPASYN-MONOMER
BioB	PROTEIN	BIOTIN-SYN-MONOMER
BioC	PROTEIN	EG10119-MONOMER
BioD	PROTEIN	DETHIOBIOTIN-SYN-MONOMER
BioF	PROTEIN	7KAPSYN-MONOMER
BirA	PROTEIN
BirA-biotinyl-5'-AMP	COMPLEX
CO2	SIMPLE_MOLECULE	CARBON-DIOXIDE
DAPA	SIMPLE_MOLECULE	DIAMINONONANOATE
KAPA	SIMPLE_MOLECULE	8-AMINO-7-OXONONANOATE
S-adenosyl-4-methylthio-2-oxobutanoate	SIMPLE_MOLECULE	S-ADENOSYL-4-METHYLTHIO-2-OXOBUTANOATE
SAM	SIMPLE_MOLECULE	S-ADENOSYLMETHIONINE
adenosylhomocysteine	SIMPLE_MOLECULE	ADENOSYL-HOMO-CYS
alanine	SIMPLE_MOLECULE	L-ALPHA-ALANINE
bioA	GENE
bioA_mRNA	RNA
bioBFCD	GENE
bioBFCD_mRNA	RNA
biotin	SIMPLE_MOLECULE	BIOTIN
biotinyl-5'-AMP	SIMPLE_MOLECULE
coenzyme A	SIMPLE_MOLECULE	CO-A
dethiobiotin	SIMPLE_MOLECULE	DETHIOBIOTIN
malonyl-S-ACP	SIMPLE_MOLECULE	MALONYL-ACP
malonyl-[acp] methyl ester	SIMPLE_MOLECULE	|Malonyl-acp-methyl-ester|
methionine	SIMPLE_MOLECULE	MET
oxidized [2Fe-2S] ferredoxin	SIMPLE_MOLECULE	|Oxidized-2Fe-2S-Ferredoxins|
phosphate	SIMPLE_MOLECULE	|Pi|
pimelyl-CoA	SIMPLE_MOLECULE	CPD-558
pimelyl-[acp]	SIMPLE_MOLECULE	|Pimeloyl-ACPs|
reduced [2Fe-2S] ferredoxin	SIMPLE_MOLECULE	|Reduced-2Fe-2S-Ferredoxins|
sulfurated sulfur donor	SIMPLE_MOLECULE	|Sulfurated-Sulfur-Acceptors|
unsulfurated [sulfur donor]	SIMPLE_MOLECULE	|Unsulfurated-Sulfur-Acceptors|
