YkgM	PROTEIN	G6167-MONOMER
YkgO	PROTEIN	MONOMER0-2656
ZinT	PROTEIN	G7061-MONOMER
Zinc	SIMPLE_MOLECULE
Zinc	SIMPLE_MOLECULE	ZN+2
Zinc_Ext	SIMPLE_MOLECULE	ZN+2_Ext
ZnuA	PROTEIN	ZNUA-MONOMER
ZnuB	PROTEIN	ZNUB-MONOMER
ZnuC	PROTEIN	ZNUC-MONOMER
ZnuC-ZnuB-ZnuA	COMPLEX	ABC-63-CPLX
Zur	PROTEIN
Zur-Zinc	COMPLEX
ykgMO	GENE
ykgMO_mRNA	RNA
zinT	GENE
zinT_mRNA	RNA
znuA	GENE
znuA_mRNA	RNA
znuCB	GENE
znuCB_mRNA	RNA
